 0, 0, 0, 0
 1, 1, 0, 2
 1, 1, 2, 2
 3, 4, 2, 2
 5, 4, 4, 4
 5, 5, 4, 6
 5, 5, 6, 6
 7, 7, 6, 6
 7, 7, 7, 8
 9, 9, 8, 8
 9, 9, 9, 8